Adventures of Batman & Robin, The (USA)|Adventures of Batman & Robin, The
Aero Fighters (USA)|Aero Fighters
Aladdin (USA)|Aladdin
Axelay (USA)|Axelay
Battletoads in Battlemaniacs (USA)|Battletoads in Battlemaniacs
Battletoads-Double Dragon (USA)|Battletoads/Double Dragon
Blackthorne (USA)|Blackthorne
Breath of Fire (USA)|Breath of Fire
Breath of Fire II (USA)|Breath of Fire 2
Bust-A-Move (USA)|Bust-A-Move
Captain America and the Avengers (USA)|Captain America and the Avengers
Super Castlevania IV (USA)|Castlevania 4, Super
Castlevania - Dracula X (USA)|Castlevania: Dracula X
Chrono Trigger (USA)|Chrono Trigger
Chrono Trigger (Japan)|Chrono Trigger [JP]
Clay Fighter (USA)|Clay Fighter
Clay Fighter 2 - Judgment Clay (USA)|Clay Fighter 2: Judgment Clay
Contra III - The Alien Wars (USA)|Contra 3: The Alien Wars
Cybernator (USA)|Cybernator
Darius Twin (USA)|Darius Twin
Demon's Crest (USA)|Demon’s Crest
Donkey Kong Country (USA) (Rev 2)|Donkey Kong Country
Donkey Kong Country 2 - Diddy's Kong Quest (USA) (En,Fr) (Rev 1)|Donkey Kong Country 2: Diddy’s Kong Quest
Donkey Kong Country 3 - Dixie Kong's Double Trouble! (USA) (En,Fr)|Donkey Kong Country 3: Dixie Kong’s Double Trouble!
Do-Re-Mi Fantasy - Milon no Dokidoki Daibouken (Japan)|DoReMi Fantasy: Milon's DokiDoki Adventure [JP]
Dragon Quest V - Tenkuu no Hanayome (Japan)|Dragon Quest V: Hand of the Heavenly Bride [JP]
Dragon Quest VI - Maboroshi no Daichi (Japan)|Dragon Quest VI: Realms of Revelation [JP]
EarthBound (USA)|EarthBound
Earthworm Jim (USA)|Earthworm Jim
Earthworm Jim 2 (USA)|Earthworm Jim 2
Energy Breaker (Japan)|Energy Breaker [JP]
E.V.O. - Search for Eden (USA)|EVO: Search for Eden
F-Zero (USA)|F-Zero
Final Fantasy II (USA) (Rev 1)|Final Fantasy 2
Final Fantasy III (USA) (Rev 1)|Final Fantasy 3
Final Fantasy IV (Japan) (Rev 1)|Final Fantasy 4 [JP]
Final Fantasy V (Japan)|Final Fantasy 5 [JP]
Final Fantasy VI (Japan)|Final Fantasy 6 [JP]
Final Fight (USA)|Final Fight
Final Fight 2 (USA)|Final Fight 2
Final Fight 3 (USA)|Final Fight 3
Final Fight Guy (USA)|Final Fight Guy
Fire Emblem - Monshou no Nazo (Japan) (Rev 1)|Fire Emblem 3: Mystery of the Emblem [JP]
Firepower 2000 (USA)|Firepower 2000
Flashback - The Quest for Identity (USA) (En,Fr,De)|Flashback: The Quest for Identity
Front Mission (Japan) (Rev 1)|Front Mission [JP]
Front Mission Series - Gun Hazard (Japan)|Front Mission Series: Gun Hazard [JP]
Gemfire (USA)|Gemfire
Go Go Ackman (Japan)|Go! Go! Ackman [JP]
Gradius III (USA)|Gradius 3
Harvest Moon (USA)|Harvest Moon
Illusion of Gaia (USA)|Illusion of Gaia
Imperium (USA)|Imperium
Indiana Jones' Greatest Adventures (USA)|Indiana Jones’ Greatest Adventures
Jungle Book, The (USA)|Jungle Book, The
Killer Instinct (USA) (Rev 1)|Killer Instinct
Kirby Super Star (USA)|Kirby Super Star
Kirby's Dream Land 3 (USA)|Kirby’s Dream Land 3
Langrisser, Der (Japan) (Rev 1)|Langrisser 2: Der Langrisser [JP]
Legend (USA)|Legend
Liberty or Death (USA)|Liberty or Death
Lion King, The (USA)|Lion King, The
Lost Vikings, The (USA)|Lost Vikings
Lost Vikings 2 (USA)|Lost Vikings 2
Lufia _ the Fortress of Doom (USA)|Lufia & the Fortress of Doom
Lufia II - Rise of the Sinistrals (USA)|Lufia 2: Rise of the Sinistrals
Magical Drop (Japan)|Magical Drop [JP]
Magical Pop'n (Japan)|Magical Pop’n [JP]
Magical Quest Starring Mickey Mouse, The (USA)|Magical Quest Starring Mickey Mouse, The
Mega Man 7 (USA)|Mega Man 7
Mega Man X (USA) (Rev 1)|Mega Man X
Mega Man X2 (USA)|Mega Man X2
Mega Man X3 (USA)|Mega Man X3
Metal Warriors (USA)|Metal Warriors
Super Metroid (Japan, USA) (En,Ja)|Metroid 3: Super Metroid
Mickey Mania - The Timeless Adventures of Mickey Mouse (USA)|Mickey Mania: The Timeless Adventures of Mickey Mouse
NBA Jam (USA) (Rev 1)|NBA Jam
NBA Jam - Tournament Edition (USA)|NBA Jam: Tournament Edition
NHLPA Hockey 93 (USA)|NHLPA Hockey ’93
NHL '94 (USA)|NHL ’94
NHL 95 (USA)|NHL ’95
NHL 96 (USA)|NHL ’96
NHL 97 (USA) (Rev 1)|NHL ’97
NHL 98 (USA)|NHL ’98
Ninja Gaiden Trilogy (USA)|Ninja Gaiden Trilogy
Ogre Battle - The March of the Black Queen (USA)|Ogre Battle: The March of the Black Queen
P.T.O. - Pacific Theater of Operations (USA)|PTO: Pacific Theater of Operations
P.T.O. II - Pacific Theater of Operations (USA)|PTO: Pacific Theater of Operations 2
Parodius Da! - Shinwa kara Owarai e (Japan)|Parodius 2: From Myth to Laughter [JP]
Gokujou Parodius (Japan)|Parodius 3: Fantastic Journey [JP]
Jikkyou Oshaberi Parodius (Japan)|Parodius 4: Forever with Me [JP]
Phalanx (USA)|Phalanx
Pilotwings (USA)|Pilotwings
Plok (USA)|Plok
Pocky _ Rocky (USA)|Pocky & Rocky
Pocky _ Rocky 2 (USA)|Pocky & Rocky 2
Power Instinct (USA)|Power Instinct
Primal Rage (USA)|Primal Rage
Prince of Persia (USA)|Prince of Persia
Prince of Persia 2 (USA)|Prince of Persia 2
Super R-Type (USA)|R-Type, Super
R-Type III (USA)|R-Type 3
Radical Psycho Machine Racing (USA)|Radical Psycho Machine Racing
Rendering Ranger R2 (Japan) (En)|Rendering Ranger: R2 [JP]
Rock n' Roll Racing (USA)|Rock n’ Roll Racing
Romancing Sa-Ga (Japan) (Rev 1)|Romancing SaGa [JP]
Secret of Evermore (USA)|Secret of Evermore
Secret of Mana (USA)|Secret of Mana
Seiken Densetsu 3 (Japan)|Seiken Densetsu 3 [JP]
Shadowrun (USA)|Shadowrun
Soul Blazer (USA)|Soul Blazer
Space Megaforce (USA)|Space Megaforce
Sparkster (USA)|Sparkster
Star Fox (USA) (Rev 2)|Star Fox
Star Fox 2 (Japan) (Proto 2)|Star Fox 2 [Prototype]
Stunt Race FX (USA) (Rev 1)|Stunt Race FX
Sunset Riders (USA)|Sunset Riders
Super Adventure Island (USA)|Super Adventure Island
Super Adventure Island II (USA)|Super Adventure Island 2
Super Bomberman (USA)|Super Bomberman
Super Bomberman 2 (USA)|Super Bomberman 2
Super Bomber Man 3 (Japan)|Super Bomberman 3 [JP]
Super Bomber Man 4 (Japan)|Super Bomberman 4 [JP]
Super Bomber Man 5 (Japan)|Super Bomberman 5 [JP]
Super Double Dragon (USA)|Super Double Dragon
Super Drift Out - World Rally Championships (Japan) (En)|Super Drift Out: World Rally Championships [JP]
Super Ghouls'n Ghosts (USA)|Super Ghouls ’n Ghosts
Super Mario All-Stars (USA)|Super Mario All-Stars
Super Mario Kart (USA)|Super Mario Kart
Super Mario RPG - Legend of the Seven Stars (USA)|Super Mario RPG - Legend of the Seven Stars
Super Mario World (USA)|Super Mario World
Super Mario World 2 - Yoshi's Island (USA) (Rev 1)|Super Mario World 2: Yoshi’s Island
Super Nova (USA)|Super Nova
Super Punch-Out!! (USA)|Super Punch-Out!!
Super Smash T.V. (USA)|Super Smash TV
Super Star Wars (USA) (Rev 1)|Super Star Wars
Super Star Wars - The Empire Strikes Back (USA) (Rev 1)|Super Star Wars 2: The Empire Strikes Back
Super Star Wars - Return of the Jedi (USA) (Rev 1)|Super Star Wars 3: Return of the Jedi
Super Turrican (USA)|Super Turrican
Super Turrican 2 (USA)|Super Turrican 2
Tactics Ogre - Let Us Cling Together (Japan) (Rev 2)|Tactics Ogre: Let Us Cling Together [JP]
Tales of Phantasia (Japan)|Tales of Phantasia [JP]
Tecmo Super Bowl (USA)|Tecmo Super Bowl
Teenage Mutant Ninja Turtles IV - Turtles in Time (USA)|Teenage Mutant Ninja Turtles 4: Turtles in Time
Tetris _ Dr. Mario (USA)|Tetris & Dr. Mario
Tetris Attack (USA) (En,Ja)|Tetris Attack
Thunder Spirits (USA)|Thunder Spirits
U.N. Squadron (USA)|UN Squadron
Umihara Kawase (Japan)|Umihara Kawase [JP]
Wario's Woods (USA)|Wario’s Woods
Wild Guns (USA)|Wild Guns
Wizardry I-II-III - Story of Llylgamyn (Japan) (En,Ja) (NP)|Wizardry 1, 2, & 3: Story of Llylgamyn [JP]
Wizardry V - Heart of the Maelstrom (USA)|Wizardry 5: Heart of the Maelstrom
Wizardry V - Saika no Chuushin (Japan) (En,Ja)|Wizardry 5: Heart of the Maelstrom [JP]
Wizardry VI - Kindan no Mahitsu (Japan)|Wizardry 6: Bane of the Cosmic Forge [JP]
Wizardry Gaiden IV - Taima no Kodou (Japan) (Rev 1)|Wizardry Gaiden 4: Throb of the Demon’s Heart [JP]
Wolfenstein 3-D (USA)|Wolfenstein 3D
Yoshi's Cookie (USA)|Yoshi’s Cookie
Ys III - Wanderers from Ys (USA)|Ys 3: Wanderers from Ys
Ys IV - Mask of the Sun (Japan)|Ys 4: Mask of the Sun [JP]
Ys V - Ushinawareta Suna no Miyako Kefin (Japan)|Ys 5: Lost Kefin, Kingdom of Sand [JP]
Zombies Ate My Neighbors (USA)|Zombies Ate My Neighbors
Legend of Zelda, The - A Link to the Past (USA)|Zelda: A Link to the Past
